Contents	목차(Table of Contents)
Overview	개요, 전체적인 계획(글을 여는 문단)
Summary		요약(두괄식, 미괄식 모두 가능, Overview로 시작했으면 Summary로 마무리)
		=> 글이 별거 없고 선요약 정도면 Summary,
		   사실이나 의견을 제시하고 글을 여는 목적은 Overview

Preview		미리보기
Definition	정의
Introduction	소개
Objectives	목적, 목표
Prerequisites	전제 조건

Requirements	요구사항
Import		단순 임포트
Install		단순 설치
Setup		절차적 설치, 설정
Getting Started	시작하기
Scenario	계획, 절차 설명

Questions	의문점
Problem		문제점
Solution	해결책
Cautions	주의사항
Analysis	분석

How to Use	사용 방법
Usage		사용 사례, 예시
Examples	예시, 예문
Demo		실행 샘플

Remarks		설명, 비고
Benchmarks	벤치마크, 성능 테스트

Results		결과
Conclusion	결론

Source Code	소스코드
Download	다운로드
References	참고
See Also	관련 문헌들
Useful Links	유용한 링크들

Future Works	추가 계획


------
See Also :
- https://m.blog.naver.com/ktri8888/221368587388
